# # # # # # #
. . # . . . #
# . # # # . #
# . . . . . #
# # # # # . #
# . . . . . .
# # # # # # #

